333333333333333333333333333333
300300000000000000300000000003
300300000000000000300000000003
300300000000000000300000000003
300000033333300000300000000003
300000000000000000300000000003
300000000000000000000000000003
300000000000000000000000000003
333333333333360633333333333333
000000000000061600000000000000
444444444444461644444444444444
411111111111111111111111111114
411111111111111111111111111114
444411444444111111111111111114
411111111114111111111111111114
411111111114111111144444444444
411111111114111111141111111114
411111111114111111141111111114
411111111114111111111111111114
411111111114111111111111111114
444444444444444616444444444444
000000000000000626000000000000
555555555555555626555555555555
522222252222222222222222222225
522222252222222222225522255225
522222222225555222225522255225
522222222222222222225522255225
522222252222222222222222222225
522222252222222222222222222225
555555555555555555555555555555